NO textures/wall_1.xpm
SO textures/wall_2.xpm
WE textures/wall_3.xpm
EA textures/wall_4.xpm

F 220,100,0
C 225,30,0

11111111111111111111111111111
10000000000000000000000000001
10000000000000000000000000001
10000000001000000100000000001
10000000001000000100000000001
1000000000100N000100000000001
10000000001000000100000000001
10000000001111111100000000001
10000000000000000000000000001
10000000000000000000000000001
11111111111111111111111111111