NO textures/wall_1.xpm
SO textures/wall_2.xpm
WE textures/wall_3.xpm
EA textures/wall_4.xpm

F 220,100,0
C 225,30,0

11111111111111111111111111
100000000011000000000000001
1011000001110000000S0000001
10010000000000000000000011
1111111111111011000001111
1000000000110000011001111
1111011111111101110000001
1111011111111101110001001
1100000011010101110000001
1000000000000000110000001
1111111100000000110100001
        1100000111010101111111111
        1111011111101011011110101
        1111111111111111111111111
111111111111111      1111111