NO textures/wall_1.xpm
SO textures/wall_2.xpm
WE textures/wall_3.xpm
EA textures/wall_4.xpm

F 200,60,255
C 0,170,255

111111111111111111111111111111111111111111111111111111111111
100000000000000000000000000000000000000000000000000000000001
100000000000000000000000000000000000000000000000000000000001
100000000000000000000000000000000000000000000000000000000001
100000000000000000000000000000000000000000000000000000000001
100000000000000000000000000000000000000000000000000000000001
100000000000001111111111111000000000011111111111100000000001
100000000000001111111111111000000000011111111111100000000001
100000000000001111111111111000000000011111111111100000000001
100000000000001111111111111000000000011111111111100000000001
100000000000001111111111111000000000011111111111100000000001
100000000000000000000000000000000000000000000000000000000001
10000000000000000000000000000000N000000000000000000000000001
100000000000000000000000000000000000000000000000000000000001
111111111111111000000000000000000000000000000000000000000001111111111111111
              100000000000001111111111111000000000011111111111100000000001
              100000000000001           1000000000011111111111100000000001
              100000000000001           1000000000011111111111100000000001
              100000000000001           1000000000011111111111100000000001
              100000000000001111111111111000000000011111111111100000000001
              100000000000000000000000000000000000000000000000000000000001
              100000000000000000000000000000000000000000000000000000000001
              100000000000000000000000000000000000000000000000000000000001
              100000000000000000000000000000000000000000000000000000000001
              100000000000000000000000000000000000000000000000000000000001
              111111111111111111111111111111111111111111111111111111111111