WE textures/wall_3.xpm
EA textures/wall_4.xpm
NO textures/wall_1.xpm
SO textures/wall_2.xpm

C 225,30,0

F 220,100,0


        11111111111111111111111111111111
        100000000011000001     100000001
        10110000011100000011111111111111
        1001000000000000000000001
111111111011000001110000000000001
100000000011000001110111111111111
11110111111111011100000010001
11110111111111011101010010001
11000000110101011100000010001
1000000000000000110000W010001
10000000000000001101010000001
1100000111010101111101111000111
11110111 1110101 101111010001 
11111111 1111111 111111111111